11111111111111
1P000000C00CE1
1C01CC000C0C01
10000CC01CC0C1
11111111111111