1111111111111111111111111111111
1001C0000C0000010000001010000E1
1C00000000010100000000001000001
110C000010C000000100110100C0001
1000C000C0000001001000000001001
10C0000100110000000000C00100001
10001000010010100C0000111110001
1001010100001001010000000C00101
10010000100000000011000000C0101
1000010C00010000C101000C0000001
1P001C001001010001000C000000011
1111111111111111111111111111111