11111111
110001C1
11PE0011
11111100
